R 500 50000
NO ./textures/wood.xpm
SO ./textures/stone.xpm
WE ./textures/metal.xpm
EA ./textures/brick.xpm
S  ./textures/tournesol.xpm
F ./textures/grass.xpm
C ./textures/skysimpsons.xpm

1 1 1 1 1 1 1 1 1 1 1 1 1 1 1 1 1 1 1 1 1 1 1 1 1 1 1 1 1 1 1 1 1 1 1 1 1 1 1 1 1 1 1 1 1 1 1 
1 0 0 0 0 0 0 0 0 0 0 0 0 0 0 0 1 0 0 0 0 0 0 1 1 0 0 0 0 0 0 0 0 0 0 0 0 0 0 0 1 0 0 0 0 0 1 
1 0 1 0 0 0 0 0 0 0 0 0 0 0 0 0 0 0 0 0 0 0 0 0 0 0 1 0 0 0 0 0 0 0 0 0 0 0 0 0 0 0 0 0 0 0 1
1 0 1 0 0 0 0 0 0 0 0 0 0 0 0 0 1 0 0 0 0 0 0 1 1 0 1 0 0 0 0 0 0 0 0 0 0 0 0 0 1 0 0 0 0 0 1 
1 0 1 0 0 0 0 2 2 2 2 2 2 2 2 2 1 1 0 1 1 1 1 1 1 0 1 0 0 0 0 2 2 2 2 2 2 2 2 2 1 1 0 1 1 1 1 
1 0 2 0 0 0 0 2 0 2 0 2 0 2 0 2 1 0 0 0 1 1 1 0 0 2 0 0 0 0 2 0 2 0 2 0 2 0 2 1 0 0 0 0 0 0 1
1 0 1 0 0 0 0 2 0 0 0 0 0 0 0 2 1 0 0 0 0 0 0 0 0 2 0 0 0 0 2 0 2 0 2 0 2 0 2 1 0 0 0 1 0 1 1
1 0 1 0 0 0 0 0 0 0 0 0 0 0 0 0 0 0 0 0 1 1 1 0 0 2 0 0 0 0 2 0 2 0 2 0 2 0 2 1 0 0 0 1 0 0 1
1 0 1 0 0 0 0 2 0 0 0 0 0 0 0 2 1 0 0 0 0 0 0 0 0 2 0 0 0 0 2 0 2 0 2 0 2 0 2 1 0 0 0 1 0 1 1
1 0 0 0 0 0 0 2 0 0 0 0 0 0 0 2 1 0 0 0 1 1 1 0 0 2 0 0 0 0 2 0 2 0 2 0 2 0 2 1 0 0 0 0 0 0 1
1 0 0 0 0 0 0 2 2 2 2 0 2 2 2 2 1 1 1 1 1 1 1 0 0 2 0 0 0 0 2 0 2 0 2 0 2 0 2 1 0 0 0 1 1 1 1
1 1 1 1 1 1 1 1 1 1 1 0 1 1 1 1 1 1 1 1 1 1 1 0 0 2 0 0 0 0 2 0 2 0 2 0 2 0 2 1 0 0 0 1 2 1 1
1 0 0 0 0 0 0 0 0 0 0 0 0 0 0 0 0 0 0 0 0 0 0 0 0 2 0 0 0 0 2 0 2 0 2 0 2 0 2 1 0 0 0 1 2 1 1
1 1 1 1 1 1 0 1 1 1 1 0 1 1 1 1 1 1 1 1 1 1 1 0 0 2 0 0 0 0 2 0 2 0 2 0 2 0 2 1 0 0 0 1 1 1 1
1 1 1 1 1 1 0 1 1 1 1 0 1 1 1 1 1 1 1 1 1 1 1 0 0 2 0 0 0 0 2 0 2 0 2 0 2 0 2 1 0 0 0 1 1 1 1
1 0 0 0 0 0 0 0 0 1 1 0 1 1 0 0 0 0 0 1 0 0 0 0 0 2 0 0 0 0 2 0 2 0 2 0 2 0 2 1 0 0 0 1 1 1 1
1 0 0 0 0 0 0 0 0 0 0 0 1 1 0 0 2 0 0 1 0 0 0 0 0 2 0 0 0 0 2 0 2 0 2 0 2 0 2 1 0 0 0 1 1 1 1
1 0 0 0 0 0 0 0 0 1 1 0 1 1 0 0 0 0 0 1 1 0 1 0 0 2 0 0 0 0 2 0 2 0 2 0 2 0 2 1 0 0 0 1 1 1 1
1 0 1 0 1 0 0 0 0 1 1 0 0 0 0 0 2 0 0 0 0 0 0 0 0 2 0 0 0 0 2 0 2 0 2 0 2 0 2 1 0 0 0 1 1 1 1
1 0 0 2 0 0 0 0 0 1 1 0 1 1 0 0 0 0 0 1 1 0 1 0 0 2 0 0 0 0 2 0 2 0 2 0 2 0 2 1 0 0 0 1 1 1 1
1 0 1 0 1 0 0 0 0 1 1 0 1 1 0 0 2 0 0 1 0 0 0 0 0 2 0 0 0 0 2 0 2 0 2 0 2 0 2 1 0 0 0 1 1 1 1
1 0 0 0 0 0 0 0 0 1 1 0 1 1 0 0 0 0 0 1 0 0 0 0 0 2 0 0 0 0 2 0 2 0 2 0 2 0 2 1 0 0 0 1 1 1 1
1 1 1 1 1 1 1 1 1 1 1 1 1 1 1 1 1 1 1 1 1 1 1 0 0 2 0 0 0 0 2 0 2 0 2 0 2 0 2 1 0 0 0 1 1 1 1
1 1 1 1 1 1 1 1 1 1 1 1 1 1 1 1 1 1 1 1 1 1 1 0 0 2 0 0 0 0 2 0 2 0 2 0 2 0 2 1 0 0 0 1 1 1 1
1 0 0 0 0 0 0 0 0 0 0 0 0 0 0 0 1 0 0 0 0 0 0 0 0 2 0 0 0 0 2 0 2 0 2 0 2 0 2 1 0 0 0 1 1 1 1
1 0 1 0 0 0 0 0 0 0 0 0 0 0 0 0 0 0 0 0 0 0 0 0 0 2 0 0 0 0 2 0 2 0 2 0 2 0 2 1 0 0 0 1 1 1 1
1 0 1 0 0 0 0 0 0 0 0 0 0 0 0 0 0 0 0 0 0 0 0 0 0 2 0 0 0 0 2 0 2 0 2 0 2 0 2 1 0 0 0 1 1 1 1
1 0 1 0 0 0 0 0 0 0 0 0 0 0 0 0 1 0 0 0 0 0 0 0 0 2 0 0 0 0 2 0 2 0 2 0 2 0 2 1 0 0 0 1 1 1 1
1 0 1 0 0 0 0 2 2 2 2 2 2 2 2 2 1 1 0 1 1 1 1 0 0 2 0 0 0 0 2 0 2 0 2 0 2 0 2 1 0 0 0 1 1 1 1
1 0 2 0 0 0 0 2 0 2 0 2 0 2 0 2 1 0 0 0 1 1 1 0 0 2 0 0 0 0 2 0 2 0 2 0 2 0 2 1 0 0 0 1 1 1 1
1 0 1 0 0 0 0 2 0 0 0 0 0 0 0 2 1 0 0 0 0 0 0 0 0 2 0 0 0 0 2 0 2 0 2 0 2 0 2 1 0 0 0 1 1 1 1
1 0 1 0 0 0 0 0 0 0 0 0 0 0 0 0 0 0 0 0 1 1 1 0 0 2 0 0 0 0 2 0 2 0 2 0 2 0 2 1 0 0 0 1 1 1 1
1 0 1 0 0 0 0 2 0 0 0 0 0 0 0 2 1 0 0 0 0 0 0 0 0 2 0 0 0 0 2 0 2 0 2 0 2 0 2 1 0 0 0 1 1 1 1
1 0 0 0 0 0 0 2 0 0 0 0 0 0 0 2 1 0 0 0 1 1 1 0 0 2 0 0 0 0 2 0 2 0 2 0 2 0 2 1 0 0 0 1 1 1 1
1 0 0 0 0 0 0 2 2 2 2 0 2 2 2 2 1 1 1 1 1 1 1 0 0 2 0 0 0 0 2 0 2 0 2 0 2 0 2 1 0 0 0 1 1 1 1
1 1 1 1 1 1 1 1 1 1 1 0 1 1 1 1 1 1 1 1 1 1 1 0 0 2 0 0 0 0 2 0 2 0 2 0 2 0 2 1 0 0 0 1 1 1 1
1 0 0 0 0 0 0 0 0 0 0 0 0 0 0 0 0 0 0 0 0 0 0 0 0 2 0 0 0 0 2 0 2 0 2 0 2 0 2 1 0 0 0 1 1 1 1
1 1 1 1 1 1 0 1 1 1 1 0 1 1 1 1 1 1 1 1 1 1 1 0 0 2 0 0 0 0 2 0 2 0 2 0 2 0 2 1 0 0 0 1 1 1 1
1 1 1 1 1 1 0 1 1 1 1 0 1 1 1 1 1 1 1 1 1 1 1 0 0 2 0 0 0 0 2 0 2 0 N 0 2 0 2 1 0 0 0 1 1 1 1
1 0 0 0 0 0 0 0 0 1 1 0 1 1 0 0 0 0 0 1 0 0 0 0 0 2 0 0 0 0 2 0 2 0 2 0 2 0 2 1 0 0 0 1 1 1 1
1 0 0 0 0 0 0 0 0 0 0 0 1 1 0 0 2 0 0 1 0 0 0 0 0 2 0 0 0 0 2 0 2 0 2 0 2 0 2 1 0 0 0 1 1 1 1
1 0 0 0 0 0 0 0 0 1 1 0 1 1 0 0 0 0 0 1 1 0 1 0 0 2 0 0 0 0 2 0 2 0 2 0 2 0 2 1 0 0 0 1 1 1 1
1 0 1 0 1 0 0 0 0 1 1 0 0 0 0 0 2 0 0 0 0 0 0 0 0 2 0 0 0 0 2 0 2 0 2 0 2 0 2 1 0 0 0 1 1 1 1
1 0 0 2 0 0 0 0 0 1 1 0 1 1 0 0 0 0 0 1 1 0 1 0 0 2 0 1 1 0 2 0 2 0 2 0 2 0 2 1 0 0 0 1 1 1 1
1 0 1 0 1 0 0 0 0 1 1 0 1 1 0 0 2 0 0 1 0 0 0 0 0 2 0 0 0 0 2 0 2 0 2 0 2 0 2 1 0 0 0 1 1 1 1
1 0 0 0 0 0 0 0 0 1 1 0 1 1 0 0 0 0 0 1 0 0 0 0 0 2 0 0 0 0 2 0 2 0 2 0 2 0 2 1 0 0 0 1 1 1 1
1 1 1 1 1 1 1 1 1 1 1 1 1 1 1 1 1 1 1 1 1 1 1 0 0 2 0 0 0 0 2 0 2 0 2 0 2 0 2 1 0 0 0 1 1 1 1
1 1 1 1 1 1 1 1 1 1 1 1 1 1 1 1 1 1 1 1 1 1 1 0 0 2 0 0 0 0 2 0 2 0 2 0 2 0 2 1 0 0 0 1 1 1 1
1 0 0 0 0 0 0 0 0 0 0 0 0 0 0 0 1 0 0 0 0 0 0 0 0 2 0 0 0 0 2 0 2 0 2 0 2 0 2 1 0 0 0 1 1 1 1
1 0 1 0 0 0 0 0 0 0 0 0 0 0 0 0 0 0 0 0 0 0 0 0 0 2 0 0 0 0 2 0 2 0 2 0 2 0 2 1 0 0 0 1 1 1 1
1 0 1 0 0 0 0 0 0 0 0 0 0 0 0 0 0 0 0 0 0 0 0 0 0 2 0 0 0 0 2 0 2 0 2 0 2 0 2 1 0 0 0 1 1 1 1
1 0 1 0 0 0 0 0 0 0 0 0 0 0 0 0 1 0 0 0 0 0 0 0 0 2 0 0 0 0 2 0 2 0 2 0 2 0 2 1 0 0 0 1 1 1 1
1 0 1 0 0 0 0 2 2 2 2 2 2 2 2 2 1 1 0 1 1 1 1 0 0 2 0 0 0 0 2 0 2 0 2 0 2 0 2 1 0 0 0 1 1 1 1
1 0 2 0 0 0 0 2 0 2 0 2 0 2 0 2 1 0 0 0 1 1 1 0 0 2 0 0 0 0 2 0 2 0 2 0 2 0 2 1 0 0 0 1 1 1 1
1 0 1 0 0 0 0 2 0 0 0 0 0 0 0 2 1 0 0 0 0 0 0 0 0 2 0 0 0 0 2 0 2 0 2 0 2 0 2 1 0 0 0 1 1 1 1
1 0 1 0 0 0 0 0 0 0 0 0 0 0 0 0 0 0 0 0 1 1 1 0 0 2 0 0 0 0 2 0 2 0 2 0 2 0 2 1 0 0 0 1 1 1 1
1 0 1 0 0 0 0 2 0 0 0 0 0 0 0 2 1 0 0 0 0 0 0 0 0 2 0 0 0 0 2 0 2 0 2 0 2 0 2 1 0 0 0 1 1 1 1
1 0 0 0 0 0 0 2 0 0 0 0 0 0 0 2 1 0 0 0 1 1 1 0 0 2 0 0 0 0 2 0 2 0 2 0 2 0 2 1 0 0 0 1 1 1 1
1 0 0 0 0 0 0 2 2 2 2 0 2 2 2 2 1 1 1 1 1 1 1 0 0 2 0 0 0 0 2 0 2 0 2 0 2 0 2 1 0 0 0 1 1 1 1
1 1 1 1 1 1 1 1 1 1 1 0 1 1 1 1 1 1 1 1 1 1 1 0 0 2 0 0 0 0 2 0 2 0 2 0 2 0 2 1 0 0 0 1 1 1 1
1 0 0 0 0 0 0 0 0 0 0 0 0 0 0 0 0 0 0 0 0 0 0 0 0 2 0 0 0 0 2 0 2 0 2 0 2 0 2 1 0 0 0 1 1 1 1
1 1 1 1 1 1 0 1 1 1 1 0 1 1 1 1 1 1 1 1 1 1 1 0 0 2 0 0 0 0 2 0 2 0 2 0 2 0 2 1 0 0 0 1 1 1 1
1 1 1 1 1 1 0 1 1 1 1 0 1 1 1 1 1 1 1 1 1 1 1 0 0 2 0 0 0 0 2 0 2 0 2 0 2 0 2 1 0 0 0 1 1 1 1
1 0 0 0 0 0 0 0 0 1 1 0 1 1 0 0 0 0 0 1 0 0 0 0 0 2 0 0 0 0 2 0 2 0 2 0 2 0 2 1 0 0 0 1 1 1 1
1 0 0 0 0 0 0 0 0 0 0 0 1 1 0 0 2 0 0 1 0 0 0 0 0 2 0 0 0 0 2 0 2 0 2 0 2 0 2 1 0 0 0 1 1 1 1
1 0 0 0 0 0 0 0 0 1 1 0 1 1 0 0 0 0 0 1 1 0 1 0 0 2 0 0 0 0 2 0 2 0 2 0 2 0 2 1 0 0 0 1 1 1 1
1 0 1 0 1 0 0 0 0 1 1 0 0 0 0 0 2 0 0 0 0 0 0 0 0 2 0 0 0 0 2 0 2 0 2 0 2 0 2 1 0 0 0 1 1 1 1
1 0 0 2 0 0 0 0 0 1 1 0 1 1 0 0 0 0 0 1 1 0 1 0 0 2 0 0 0 0 2 0 2 0 2 0 2 0 2 1 0 0 0 1 1 1 1
1 0 1 0 1 0 0 0 0 1 1 0 1 1 0 0 2 0 0 1 0 0 0 0 0 2 0 0 0 0 2 0 2 0 2 0 2 0 2 1 0 0 0 1 1 1 1
1 0 0 0 0 0 0 0 0 1 1 0 1 1 0 0 0 0 0 1 0 0 0 0 0 2 0 0 0 0 2 0 2 0 2 0 2 0 2 1 0 0 0 1 1 1 1
1 1 1 1 1 1 1 1 1 1 1 1 1 1 1 1 1 1 1 1 1 1 1 1 1 1 1 1 1 1 1 1 1 1 1 1 1 1 1 1 1 1 1 1 1 1 1